1 9 9 9 9 9 9 9 9 9 9 9 9 9 9 9 9 9 9 9 9 9 9 9 9 9 9 9 9 9 9 1
9 z 1 0 0 0 0 0 0 0 0 0 0 0 0 0 0 0 0 0 0 0 0 0 0 0 0 0 0 0 0 9
9 0 0 0 0 0 1 0 0 0 0 0 0 0 0 0 0 0 0 0 0 0 0 0 0 0 0 0 a 0 0 9
9 0 1 0 0 0 1 0 0 0 0 0 b 0 0 z 0 0 0 0 0 0 1 0 1 0 1 0 0 0 0 9
9 0 0 0 0 0 1 0 0 0 0 0 0 0 0 0 0 0 0 0 0 0 0 0 0 0 0 0 0 0 0 9
9 1 1 1 1 1 1 0 0 0 0 0 0 0 0 0 0 0 0 0 0 0 1 0 20 0 3 0 0 0 0 9
9 0 0 0 0 0 0 0 0 0 0 0 0 2 3 0 3 2 0 0 0 0 0 0 0 0 0 0 0 0 0 9
9 0 0 0 a 0 0 0 c 0 0 0 0 2 0 0 0 2 0 0 0 0 1 0 3 0 4 0 0 0 0 9
9 0 0 0 0 0 0 0 0 a 0 0 0 2 0 0 0 2 0 0 0 0 0 0 0 0 0 0 0 0 0 9
9 0 0 0 0 0 0 0 0 0 0 0 0 2 0 0 0 2 0 0 a 0 0 0 0 0 0 0 0 0 0 9
9 0 0 0 a 0 0 0 0 0 c 0 c 1 0 0 0 2 0 0 0 0 0 0 0 0 0 0 0 0 0 9
9 0 0 0 8 3 3 3 3 3 3 3 3 3 0 0 0 2 3 4 2 3 4 5 6 7 8 9 0 0 0 9
9 0 0 0 8 0 0 0 0 0 0 0 0 0 0 0 0 0 0 0 0 0 0 0 0 0 0 1 0 0 0 9
9 0 0 0 8 0 0 0 0 0 0 0 0 0 0 0 0 0 0 0 0 0 0 0 0 0 0 5 0 0 0 9
9 0 0 0 8 0 0 0 0 0 0 0 0 5 0 0 0 5 0 0 a 0 0 0 0 0 0 5 0 0 0 9
9 0 0 0 8 0 0 0 a 0 0 0 0 0 0 0 0 0 0 0 0 0 0 0 0 0 0 5 0 0 0 9
9 0 0 0 8 0 0 0 0 0 0 0 0 0 0 0 0 0 0 0 0 0 0 0 0 0 0 5 0 0 0 9
9 0 0 0 8 0 0 0 0 0 0 0 0 5 0 0 0 5 0 0 0 0 0 0 0 0 0 5 0 0 0 9
9 0 0 0 8 0 0 0 0 0 0 0 0 0 0 0 0 0 0 0 0 0 0 0 0 0 0 5 0 0 0 9
9 0 0 0 8 0 1 1 1 1 1 0 0 0 0 0 0 0 0 0 1 1 1 1 1 1 0 5 0 0 0 9
9 0 0 0 8 0 0 0 0 0 1 0 0 5 0 0 0 5 0 0 1 0 0 0 0 0 0 5 0 0 0 9
9 0 0 0 8 0 0 0 0 0 1 0 0 0 0 0 0 0 0 0 1 0 1 0 0 0 0 5 0 0 0 9
9 0 0 0 8 0 0 0 0 0 1 0 0 0 0 0 0 0 0 0 1 0 a 0 0 0 0 5 0 0 0 9
9 0 0 0 8 1 1 1 0 0 1 0 0 5 0 0 0 5 0 0 1 0 0 0 0 0 0 5 0 0 0 9
9 0 0 0 8 0 0 0 0 0 1 0 0 0 0 0 0 a 0 0 1 0 1 0 0 1 0 5 0 0 0 9
9 0 0 0 8 0 0 0 0 0 1 0 0 0 0 0 0 0 0 0 1 0 0 0 0 0 0 5 0 0 0 9
9 0 0 0 5 5 5 5 5 5 5 5 5 5 5 5 5 5 5 5 5 5 5 5 5 5 5 5 0 0 0 9
9 a 0 0 0 0 0 0 0 0 0 0 0 0 0 0 a 0 0 0 0 0 0 0 0 0 0 0 0 0 0 9
9 0 0 0 0 0 0 0 0 0 0 0 0 0 0 0 0 0 0 0 a 0 0 0 0 0 0 0 0 0 0 9
9 0 0 0 2 2 2 2 2 2 2 2 2 2 2 2 2 2 2 2 2 2 2 2 2 2 2 2 0 0 0 9
9 0 0 0 0 0 0 1 0 0 0 0 0 1 0 0 0 0 0 1 0 0 0 0 0 1 0 0 0 0 0 9
9 0 0 0 0 0 0 1 0 0 0 0 0 1 0 0 0 0 0 1 0 0 0 0 0 1 0 0 0 0 0 9
9 0 0 0 4 0 0 1 0 0 1 0 0 1 0 a 1 0 0 1 0 0 1 0 0 1 0 3 0 0 0 9
9 0 0 0 4 0 0 1 0 0 1 0 0 1 0 0 1 0 0 1 0 0 1 0 0 1 0 3 0 0 0 9
9 0 0 a 4 b 0 0 0 0 1 0 0 0 0 0 1 0 0 0 0 0 1 0 0 0 0 4 0 0 0 9
9 0 0 0 4 0 0 0 0 0 1 0 0 0 0 0 1 0 0 0 a 0 1 0 0 0 0 3 0 0 0 9
9 0 0 0 2 2 2 2 2 2 2 2 2 2 2 2 2 2 2 2 2 2 2 2 2 2 2 2 0 0 0 9
9 0 0 0 0 0 0 0 0 0 0 0 0 0 0 0 0 0 0 0 0 0 0 0 0 0 0 0 0 0 0 9
9 9 9 9 9 9 9 9 9 9 9 9 9 9 9 9 9 9 9 9 9 9 9 9 9 9 9 9 9 9 9 9
