1,0,0,0 5,0,0,0 5,0,0,0 5,0,0,0 5,0,0,0 5,0,0,0 5,0,0,0 5,0,0,0 1,0,0,0
1,0,0,0 1,0,0,0 0,0,0,0 0,0,0,0 0,0,0,0 0,0,0,0 0,0,0,0 0,0,0,0 1,0,0,0
1,0,0,0 0,0,0,0 0,0,0,0 0,0,0,0 0,0,0,0 0,0,0,0 0,0,0,0 0,0,0,0 1,0,0,0
1,0,0,0 0,0,0,0 0,0,0,0 0,0,0,0 z,0,0,0 0,0,0,0 0,0,0,0 0,0,0,0 1,0,0,0
1,0,0,0 0,0,0,0 0,0,0,0 0,0,0,0 0,0,0,0 0,0,0,0 0,0,0,0 0,0,0,0 1,0,0,0
1,0,0,0 1,0,0,0 0,0,0,0 0,0,0,0 0,0,0,0 0,0,0,0 0,0,0,0 0,0,0,0 1,0,0,0
1,0,0,0 5,0,0,0 5,0,0,0 5,0,0,0 5,0,0,0 5,0,0,0 5,0,0,0 5,0,0,0 1,0,0,0
-
1,0,0,0 6,0,0,0 6,0,0,0 6,0,0,0 6,0,0,0 6,0,0,0 6,0,0,0 6,0,0,0 1,0,0,0
1,0,0,0 0,0,0,0 0,0,0,0 0,0,0,0 1,0,0,0 1,0,0,0 1,0,0,0 1,0,0,0 1,0,0,0
1,0,0,0 0,0,0,0 0,0,0,0 0,0,0,0 1,0,0,0 1,0,0,0 1,0,0,0 1,0,0,0 1,0,0,0
1,0,0,0 0,0,0,0 0,0,0,0 0,0,0,0 1,0,0,0 1,0,0,0 1,0,0,0 1,0,0,0 1,0,0,0
1,0,0,0 0,0,0,0 0,0,0,0 0,0,0,0 1,0,0,0 1,0,0,0 1,0,0,0 1,0,0,0 1,0,0,0
1,0,0,0 0,0,0,0 0,0,0,0 0,0,0,0 1,0,0,0 1,0,0,0 1,0,0,0 1,0,0,0 1,0,0,0
1,0,0,0 6,0,0,0 6,0,0,0 6,0,0,0 6,0,0,0 6,0,0,0 6,0,0,0 6,0,0,0 1,0,0,0
-
1,0,0,0 1,0,0,0 1,0,0,0 1,0,0,0 1,0,0,0 1,0,0,0 1,0,0,0 1,0,0,0 1,0,0,0
1,0,0,0 0,0,0,0 0,0,0,0 0,0,0,0 a,0,0,0 1,0,0,0 0,0,0,0 0,0,0,0 1,0,0,0
1,0,0,0 0,0,0,0 0,0,0,0 0,0,0,0 a,0,0,0 1,0,0,0 0,0,0,0 0,0,0,0 1,0,0,0
1,0,0,0 0,0,0,0 0,0,0,0 0,0,0,0 a,0,0,0 1,0,0,0 0,0,0,0 0,0,0,0 1,0,0,0
1,0,0,0 0,0,0,0 0,0,0,0 0,0,0,0 a,0,0,0 1,0,0,0 0,0,0,0 0,0,0,0 1,0,0,0
1,0,0,0 0,0,0,0 0,0,0,0 0,0,0,0 a,0,0,0 1,0,0,0 0,0,0,0 0,0,0,0 1,0,0,0
1,0,0,0 1,0,0,0 1,0,0,0 1,0,0,0 1,0,0,0 1,0,0,0 1,0,0,0 1,0,0,0 1,0,0,0
-
1,0,0,0 1,0,0,0 1,0,0,0 1,0,0,0 1,0,0,0 1,0,0,0 1,0,0,0 1,0,0,0 1,0,0,0
1,0,0,0 0,0,0,0 0,0,0,0 0,0,0,0 0,0,0,0 b,0,0,0 0,0,0,0 0,0,0,0 1,0,0,0
1,0,0,0 0,0,0,0 0,0,0,0 0,0,0,0 0,0,0,0 b,0,0,0 0,0,0,0 0,0,0,0 1,0,0,0
1,0,0,0 0,0,0,0 0,0,0,0 0,0,0,0 0,0,0,0 b,0,0,0 0,0,0,0 0,0,0,0 1,0,0,0
1,0,0,0 0,0,0,0 0,0,0,0 0,0,0,0 0,0,0,0 b,0,0,0 0,0,0,0 0,0,0,0 1,0,0,0
1,0,0,0 0,0,0,0 0,0,0,0 0,0,0,0 0,0,0,0 b,0,0,0 0,0,0,0 0,0,0,0 1,0,0,0
1,0,0,0 1,0,0,0 1,0,0,0 1,0,0,0 1,0,0,0 1,0,0,0 1,0,0,0 1,0,0,0 1,0,0,0
-
1,0,0,0 6,0,0,0 1,0,0,0 1,0,0,0 1,0,0,0 1,0,0,0 1,0,0,0 1,0,0,0 1,0,0,0
1,0,0,0 0,0,0,0 0,0,0,0 0,0,0,0 0,0,0,0 1,0,0,0 0,0,0,0 0,0,0,0 1,0,0,0
1,0,0,0 0,0,0,0 0,0,0,0 0,0,0,0 0,0,0,0 1,0,0,0 0,0,0,0 0,0,0,0 1,0,0,0
1,0,0,0 0,0,0,0 0,0,0,0 0,0,0,0 0,0,0,0 1,0,0,0 0,0,0,0 0,0,0,0 1,0,0,0
1,0,0,0 0,0,0,0 0,0,0,0 0,0,0,0 0,0,0,0 1,0,0,0 0,0,0,0 0,0,0,0 1,0,0,0
1,0,0,0 0,0,0,0 0,0,0,0 0,0,0,0 0,0,0,0 1,0,0,0 0,0,0,0 0,0,0,0 1,0,0,0
1,0,0,0 6,0,0,0 1,0,0,0 1,0,0,0 1,0,0,0 1,0,0,0 1,0,0,0 1,0,0,0 1,0,0,0
