5,3,0,0 5,3,0,0 5,3,0,0 5,3,0,0 5,3,0,0 5,3,0,0 5,3,0,0 5,3,0,0 5,3,0,1
5,3,0,0 0,3,0,0 0,3,0,0 0,3,0,0 0,3,0,0 0,3,0,0 0,3,0,0 0,3,0,0 5,3,0,1
5,3,0,0 0,3,0,0 0,3,0,0 0,3,0,0 0,3,0,0 0,3,0,0 0,3,0,0 0,3,0,0 5,3,0,1
5,3,0,0 0,3,0,0 0,3,0,0 0,3,0,0 0,3,0,0 0,3,0,0 0,3,0,0 0,3,0,0 5,3,0,1
5,3,0,0 0,3,0,0 0,3,0,0 0,3,0,0 0,3,0,0 0,3,0,0 0,3,0,0 0,3,0,0 5,3,0,1
5,3,0,0 0,3,0,0 0,3,0,0 0,3,0,0 0,3,0,0 0,3,0,0 0,3,0,0 0,3,0,0 5,3,0,1
5,3,0,0 0,3,0,0 0,3,0,0 0,3,0,0 0,3,0,0 0,3,0,0 0,3,0,0 0,3,0,0 5,3,0,1
5,3,0,0 0,3,0,0 0,3,0,0 0,3,0,0 0,3,0,0 0,3,0,0 0,3,0,0 0,3,0,0 5,3,0,1
5,3,0,0 0,3,0,0 0,3,0,0 0,3,0,0 0,3,0,0 0,3,0,0 0,3,0,0 0,3,0,0 5,3,0,1
5,3,0,0 0,3,0,0 0,3,0,0 0,3,0,0 0,3,0,0 0,3,0,0 0,3,0,0 0,3,0,0 5,3,0,1
5,3,0,0 0,3,0,0 0,3,0,0 0,3,0,0 0,3,0,0 0,3,0,0 0,3,0,0 0,3,0,0 5,3,0,1
5,3,0,0 0,3,0,0 0,3,0,0 0,3,0,0 0,3,0,0 0,3,0,0 0,3,0,0 0,3,0,0 5,3,0,1
5,3,0,0 0,3,0,0 0,3,0,0 0,3,0,0 0,3,0,0 0,3,0,0 0,3,0,0 0,3,0,0 5,3,0,1
5,3,0,0 0,3,0,0 0,3,0,0 0,3,0,0 0,3,0,0 0,3,0,0 0,3,0,0 0,3,0,0 5,3,0,1
5,3,0,0 0,3,0,0 0,3,0,0 0,3,0,0 0,3,0,0 0,3,0,0 0,3,0,0 0,3,0,0 5,3,0,1
5,3,0,0 0,3,0,0 0,3,0,0 0,3,0,0 0,3,0,0 0,3,0,0 0,3,0,0 0,3,0,0 5,3,0,1
5,3,0,0 0,3,0,0 0,3,0,0 0,3,0,0 0,3,0,0 0,3,0,0 0,3,0,0 0,3,0,0 5,3,0,1
5,3,0,0 0,3,0,0 0,3,0,0 0,3,0,0 0,3,0,0 0,3,0,0 0,3,0,0 0,3,0,0 5,3,0,1
5,3,0,0 0,3,0,0 0,3,0,0 0,3,0,0 0,3,0,0 0,3,0,0 0,3,0,0 0,3,0,0 5,3,0,1
5,3,0,0 0,3,0,0 0,3,0,0 0,3,0,0 0,3,0,0 0,3,0,0 0,3,0,0 0,3,0,0 5,3,0,1
5,3,0,0 0,3,0,0 0,3,0,0 0,3,0,0 0,3,0,0 0,3,0,0 0,3,0,0 0,3,0,0 5,3,0,1
5,3,0,0 0,3,0,0 0,3,0,0 0,3,0,0 0,3,0,0 0,3,0,0 0,3,0,0 0,3,0,0 5,3,0,1
5,3,0,0 0,3,0,0 0,3,0,0 0,3,0,0 0,3,0,0 0,3,0,0 0,3,0,0 0,3,0,0 5,3,0,1
5,3,0,0 0,3,0,0 0,3,0,0 0,3,0,0 0,3,0,0 0,3,0,0 0,3,0,0 0,3,0,0 5,3,0,1
5,3,0,0 0,3,0,0 0,3,0,0 0,3,0,0 0,3,0,0 0,3,0,0 0,3,0,0 0,3,0,0 5,3,0,1
5,3,0,0 0,3,0,0 0,3,0,0 0,3,0,0 0,3,0,0 0,3,0,0 0,3,0,0 0,3,0,0 5,3,0,1
5,3,0,0 0,3,0,0 0,3,0,0 0,3,0,0 0,3,0,0 0,3,0,0 0,3,0,0 0,3,0,0 5,3,0,1
5,3,0,0 0,3,0,0 0,3,0,0 0,3,0,0 0,3,0,0 0,3,0,0 0,3,0,0 0,3,0,0 5,3,0,1
5,3,0,0 0,3,0,0 0,3,0,0 0,3,0,0 0,3,0,0 0,3,0,0 0,3,0,0 0,3,0,0 5,3,0,1
5,3,0,0 0,3,0,0 0,3,0,0 0,3,0,0 0,3,0,0 0,3,0,0 0,3,0,0 0,3,0,0 5,3,0,1
5,3,0,0 0,3,0,0 0,3,0,0 0,3,0,0 0,3,0,0 0,3,0,0 0,3,0,0 0,3,0,0 5,3,0,1
5,3,0,0 0,3,0,0 0,3,0,0 0,3,0,0 0,3,0,0 0,3,0,0 0,3,0,0 0,3,0,0 5,3,0,1
5,3,0,0 0,3,0,0 0,3,0,0 0,3,0,0 0,3,0,0 0,3,0,0 0,3,0,0 0,3,0,0 5,3,0,1
5,3,0,0 0,3,0,0 0,3,0,0 0,3,0,0 0,3,0,0 0,3,0,0 0,3,0,0 0,3,0,0 5,3,0,1
5,3,0,0 0,3,0,0 0,3,0,0 0,3,0,0 0,3,0,0 0,3,0,0 0,3,0,0 0,3,0,0 5,3,0,1
5,3,0,0 0,3,0,0 0,3,0,0 0,3,0,0 0,3,0,0 0,3,0,0 0,3,0,0 0,3,0,0 5,3,0,1
5,3,0,0 0,3,0,0 0,3,0,0 0,3,0,0 0,3,0,0 0,3,0,0 0,3,0,0 0,3,0,0 5,3,0,1
5,3,0,0 0,3,0,0 0,3,0,0 0,3,0,0 0,3,0,0 0,3,0,0 0,3,0,0 0,3,0,0 5,3,0,1
5,3,0,0 0,3,0,0 0,3,0,0 0,3,0,0 0,3,0,0 0,3,0,0 0,3,0,0 0,3,0,0 5,3,0,1
5,3,0,0 0,3,0,0 0,3,0,0 0,3,0,0 0,3,0,0 0,3,0,0 0,3,0,0 0,3,0,0 5,3,0,1
5,3,0,0 0,3,0,0 0,3,0,0 0,3,0,0 0,3,0,0 0,3,0,0 0,3,0,0 0,3,0,0 5,3,0,1
5,3,0,0 0,3,0,0 0,3,0,0 0,3,0,0 0,3,0,0 0,3,0,0 0,3,0,0 0,3,0,0 5,3,0,1
5,3,0,0 0,3,0,0 0,3,0,0 0,3,0,0 0,3,0,0 0,3,0,0 0,3,0,0 0,3,0,0 5,3,0,1
5,3,0,0 0,3,0,0 0,3,0,0 0,3,0,0 0,3,0,0 0,3,0,0 0,3,0,0 0,3,0,0 5,3,0,1
5,3,0,0 5,3,0,0 5,3,0,0 5,3,0,0 5,3,0,0 5,3,0,0 5,3,0,0 5,3,0,0 5,3,0,1
-
8,0,0,0 8,0,0,0 8,0,0,0 8,0,0,0 8,0,0,0 8,0,0,0 8,0,0,0 8,0,0,0 8,0,0,0
8,0,0,0 0,0,0,0 0,0,0,0 0,0,0,0 0,0,0,0 0,0,0,0 0,0,0,0 0,0,0,0 8,0,0,0
8,0,0,0 0,0,0,0 0,0,0,0 0,0,0,0 0,0,0,0 0,0,0,0 0,0,0,0 0,0,0,0 8,0,0,0
8,0,0,0 0,0,0,0 0,0,0,0 0,0,0,0 0,0,0,0 0,0,0,0 0,0,0,0 0,0,0,0 8,0,0,0
8,0,0,0 0,0,0,0 0,0,0,0 0,0,0,0 0,0,0,0 0,0,0,0 0,0,0,0 0,0,0,0 8,0,0,0
8,0,0,0 0,0,0,0 0,0,0,0 0,0,0,0 0,0,0,0 0,0,0,0 0,0,0,0 0,0,0,0 8,0,0,0
8,0,0,0 0,0,0,0 0,0,0,0 0,0,0,0 0,0,0,0 0,0,0,0 2,0,0,0 0,0,0,0 8,0,0,0
8,0,0,0 0,0,0,0 0,0,0,0 0,0,0,0 0,0,0,0 0,0,0,0 0,0,0,0 0,0,0,0 8,0,0,0
8,0,0,0 0,0,0,0 0,0,0,0 0,0,0,0 0,0,0,0 0,0,0,0 0,0,0,0 0,0,0,0 8,0,0,0
8,0,0,0 0,0,0,0 0,0,0,0 0,0,0,0 0,0,0,0 0,0,0,0 0,0,0,0 0,0,0,0 8,0,0,0
8,0,0,0 0,0,0,0 0,0,0,0 0,0,0,0 0,0,0,0 0,0,0,0 0,0,0,0 0,0,0,0 8,0,0,0
8,0,0,0 0,0,0,0 0,0,0,0 0,0,0,0 0,0,0,0 0,0,0,0 0,0,0,0 0,0,0,0 8,0,0,0
8,0,0,0 0,0,0,0 0,0,0,0 0,0,0,0 0,0,0,0 0,0,0,0 0,0,0,0 0,0,0,0 8,0,0,0
8,0,0,0 0,0,0,0 0,0,0,0 0,0,0,0 0,0,0,0 0,0,0,0 0,0,0,0 0,0,0,0 8,0,0,0
8,0,0,0 0,0,0,0 0,0,0,0 0,0,0,0 0,0,0,0 0,0,0,0 0,0,0,0 0,0,0,0 8,0,0,0
8,0,0,0 0,0,0,0 0,0,0,0 0,0,0,0 0,0,0,0 2,0,0,0 0,0,0,0 0,0,0,0 8,0,0,0
8,0,0,0 0,0,0,0 0,0,0,0 0,0,0,0 0,0,0,0 2,0,0,0 0,0,0,0 0,0,0,0 8,0,0,0
8,0,0,0 0,0,0,0 0,0,0,0 0,0,0,0 0,0,0,0 2,0,0,0 0,0,0,0 0,0,0,0 8,0,0,0
8,0,0,0 0,0,0,0 0,0,0,0 0,0,0,0 0,0,0,0 0,0,0,0 0,0,0,0 0,0,0,0 8,0,0,0
8,0,0,0 0,0,0,0 0,0,0,0 0,0,0,0 0,0,0,0 0,0,0,0 0,0,0,0 0,0,0,0 8,0,0,0
8,0,0,0 0,0,0,0 0,0,0,0 0,0,0,0 0,0,0,0 0,0,0,0 0,0,0,0 0,0,0,0 8,0,0,0
8,0,0,0 0,0,0,0 0,0,0,0 0,0,0,0 0,0,0,0 0,0,0,0 0,0,0,0 0,0,0,0 8,0,0,0
8,0,0,0 0,0,0,0 0,0,0,0 0,0,0,0 0,0,0,0 0,0,0,0 0,0,0,0 0,0,0,0 8,0,0,0
8,0,0,0 0,0,0,0 0,0,0,0 0,0,0,0 0,0,0,0 0,0,0,0 0,0,0,0 0,0,0,0 8,0,0,0
8,0,0,0 0,0,0,0 0,0,0,0 0,0,0,0 0,0,0,0 0,0,0,0 0,0,0,0 0,0,0,0 8,0,0,0
8,0,0,0 0,0,0,0 0,0,0,0 0,0,0,0 0,0,0,0 0,0,0,0 0,0,0,0 0,0,0,0 8,0,0,0
8,0,0,0 0,0,0,0 0,0,0,0 0,0,0,0 0,0,0,0 0,0,0,0 0,0,0,0 0,0,0,0 8,0,0,0
8,0,0,0 0,0,0,0 0,0,0,0 0,0,0,0 0,0,0,0 0,0,0,0 0,0,0,0 0,0,0,0 8,0,0,0
8,0,0,0 0,0,0,0 0,0,0,0 0,0,0,0 0,0,0,0 0,0,0,0 0,0,0,0 0,0,0,0 8,0,0,0
8,0,0,0 0,0,0,0 0,0,0,0 0,0,0,0 0,0,0,0 0,0,0,0 0,0,0,0 0,0,0,0 8,0,0,0
8,0,0,0 0,0,0,0 0,0,0,0 0,0,0,0 0,0,0,0 0,0,0,0 0,0,0,0 0,0,0,0 8,0,0,0
8,0,0,0 0,0,0,0 0,0,0,0 0,0,0,0 0,0,0,0 0,0,0,0 0,0,0,0 0,0,0,0 8,0,0,0
8,0,0,0 0,0,0,0 0,0,0,0 0,0,0,0 0,0,0,0 0,0,0,0 0,0,0,0 0,0,0,0 8,0,0,0
8,0,0,0 0,0,0,0 0,0,0,0 0,0,0,0 0,0,0,0 0,0,0,0 0,0,0,0 0,0,0,0 8,0,0,0
8,0,0,0 0,0,0,0 0,0,0,0 0,0,0,0 0,0,0,0 0,0,0,0 0,0,0,0 0,0,0,0 8,0,0,0
8,0,0,0 0,0,0,0 0,0,0,0 0,0,0,0 0,0,0,0 0,0,0,0 0,0,0,0 0,0,0,0 8,0,0,0
8,0,0,0 0,0,0,0 0,0,0,0 0,0,0,0 0,0,0,0 0,0,0,0 0,0,0,0 0,0,0,0 8,0,0,0
8,0,0,0 0,0,0,0 0,0,0,0 0,0,0,0 0,0,0,0 0,0,0,0 0,0,0,0 0,0,0,0 8,0,0,0
8,0,0,0 0,0,0,0 0,0,0,0 0,0,0,0 0,0,0,0 0,0,0,0 0,0,0,0 0,0,0,0 8,0,0,0
8,0,0,0 0,0,0,0 0,0,0,0 0,0,0,0 0,0,0,0 0,0,0,0 0,0,0,0 0,0,0,0 8,0,0,0
8,0,0,0 0,0,0,0 0,0,0,0 0,0,0,0 0,0,0,0 0,0,0,0 0,0,0,0 0,0,0,0 8,0,0,0
8,0,0,0 0,0,0,0 0,0,0,0 0,0,0,0 0,0,0,0 0,0,0,0 0,0,0,0 0,0,0,0 8,0,0,0
8,0,0,0 0,0,0,0 0,0,0,0 0,0,0,0 0,0,0,0 0,0,0,0 0,0,0,0 0,0,0,0 8,0,0,0
8,0,0,0 0,0,0,0 0,0,0,0 0,0,0,0 0,0,0,0 0,0,0,0 0,0,0,0 0,0,0,0 8,0,0,0
8,0,0,0 8,0,0,0 8,0,0,0 8,0,0,0 8,0,0,0 8,0,0,0 8,0,0,0 8,0,0,0 8,0,0,0
-
2,0,0,0 2,0,0,0 2,0,0,0 2,0,0,0 2,0,0,0 2,0,0,0 2,0,0,0 2,0,0,0 2,0,0,0
2,0,0,0 0,0,0,0 0,0,0,0 0,0,0,0 0,0,0,0 0,0,0,0 0,0,0,0 0,0,0,0 2,0,0,0
2,0,0,0 0,0,0,0 0,0,0,0 0,0,0,0 0,0,0,0 0,0,0,0 0,0,0,0 0,0,0,0 2,0,0,0
2,0,0,0 0,0,0,0 0,0,0,0 0,0,0,0 0,0,0,0 0,0,0,0 0,0,0,0 0,0,0,0 2,0,0,0
2,0,0,0 0,0,0,0 0,0,0,0 0,0,0,0 0,0,0,0 0,0,0,0 0,0,0,0 0,0,0,0 2,0,0,0
2,0,0,0 0,0,0,0 0,0,0,0 0,0,0,0 0,0,0,0 0,0,0,0 0,0,0,0 0,0,0,0 2,0,0,0
2,0,0,0 0,0,0,0 2,0,0,0 0,0,0,0 0,0,0,0 0,0,0,0 0,0,0,0 2,0,0,0 2,0,0,0
2,0,0,0 0,0,0,0 2,0,0,0 0,0,0,0 0,0,0,0 0,0,0,0 0,0,0,0 0,0,0,0 2,0,0,0
2,0,0,0 0,0,0,0 2,0,0,0 2,0,0,0 0,0,0,0 0,0,0,0 0,0,0,0 0,0,0,0 2,0,0,0
2,0,0,0 0,0,0,0 0,0,0,0 2,0,0,0 0,0,0,0 0,0,0,0 0,0,0,0 0,0,0,0 2,0,0,0
2,0,0,0 0,0,0,0 2,0,0,0 2,0,0,0 0,0,0,0 0,0,0,0 0,0,0,0 0,0,0,0 2,0,0,0
2,0,0,0 0,0,0,0 2,0,0,0 0,0,0,0 0,0,0,0 0,0,0,0 0,0,0,0 0,0,0,0 2,0,0,0
2,0,0,0 0,0,0,0 2,0,0,0 2,0,0,0 0,0,0,0 0,0,0,0 2,0,0,0 0,0,0,0 2,0,0,0
2,0,0,0 0,0,0,0 0,0,0,0 2,0,0,0 0,0,0,0 2,0,0,0 2,0,0,0 0,0,0,0 2,0,0,0
2,0,0,0 0,0,0,0 2,0,0,0 2,0,0,0 0,0,0,0 0,0,0,0 0,0,0,0 0,0,0,0 2,0,0,0
2,0,0,0 0,0,0,0 2,0,0,0 0,0,0,0 0,0,0,0 0,0,0,0 0,0,0,0 0,0,0,0 2,0,0,0
2,0,0,0 0,0,0,0 0,0,0,0 0,0,0,0 0,0,0,0 0,0,0,0 0,0,0,0 0,0,0,0 2,0,0,0
2,0,0,0 0,0,0,0 0,0,0,0 0,0,0,0 0,0,0,0 0,0,0,0 2,0,0,0 0,0,0,0 2,0,0,0
2,0,0,0 0,0,0,0 0,0,0,0 0,0,0,0 0,0,0,0 0,0,0,0 2,0,0,0 0,0,0,0 2,0,0,0
2,0,0,0 0,0,0,0 0,0,0,0 0,0,0,0 0,0,0,0 0,0,0,0 2,0,0,0 0,0,0,0 2,0,0,0
2,0,0,0 0,0,0,0 2,0,0,0 2,0,0,0 0,0,0,0 0,0,0,0 2,0,0,0 0,0,0,0 2,0,0,0
2,0,0,0 0,0,0,0 2,0,0,0 2,0,0,0 0,0,0,0 0,0,0,0 0,0,0,0 0,0,0,0 2,0,0,0
2,0,0,0 0,0,0,0 0,0,0,0 2,0,0,0 0,0,0,0 0,0,0,0 0,0,0,0 0,0,0,0 2,0,0,0
2,0,0,0 0,0,0,0 0,0,0,0 2,0,0,0 0,0,0,0 0,0,0,0 0,0,0,0 0,0,0,0 2,0,0,0
2,0,0,0 0,0,0,0 0,0,0,0 0,0,0,0 0,0,0,0 0,0,0,0 0,0,0,0 0,0,0,0 2,0,0,0
2,0,0,0 0,0,0,0 0,0,0,0 0,0,0,0 0,0,0,0 0,0,0,0 0,0,0,0 0,0,0,0 2,0,0,0
2,0,0,0 0,0,0,0 0,0,0,0 0,0,0,0 0,0,0,0 0,0,0,0 0,0,0,0 0,0,0,0 2,0,0,0
2,0,0,0 0,0,0,0 0,0,0,0 0,0,0,0 0,0,0,0 0,0,0,0 0,0,0,0 0,0,0,0 2,0,0,0
2,0,0,0 0,0,0,0 0,0,0,0 0,0,0,0 0,0,0,0 0,0,0,0 0,0,0,0 0,0,0,0 2,0,0,0
2,0,0,0 0,0,0,0 0,0,0,0 0,0,0,0 0,0,0,0 0,0,0,0 0,0,0,0 0,0,0,0 2,0,0,0
2,0,0,0 0,0,0,0 0,0,0,0 0,0,0,0 0,0,0,0 0,0,0,0 0,0,0,0 0,0,0,0 2,0,0,0
2,0,0,0 0,0,0,0 0,0,0,0 0,0,0,0 0,0,0,0 0,0,0,0 0,0,0,0 0,0,0,0 2,0,0,0
2,0,0,0 0,0,0,0 0,0,0,0 0,0,0,0 0,0,0,0 0,0,0,0 0,0,0,0 0,0,0,0 2,0,0,0
2,0,0,0 0,0,0,0 0,0,0,0 0,0,0,0 0,0,0,0 0,0,0,0 0,0,0,0 0,0,0,0 2,0,0,0
2,0,0,0 0,0,0,0 0,0,0,0 0,0,0,0 0,0,0,0 0,0,0,0 0,0,0,0 0,0,0,0 2,0,0,0
2,0,0,0 0,0,0,0 0,0,0,0 0,0,0,0 0,0,0,0 0,0,0,0 0,0,0,0 0,0,0,0 2,0,0,0
2,0,0,0 0,0,0,0 0,0,0,0 0,0,0,0 0,0,0,0 0,0,0,0 0,0,0,0 0,0,0,0 2,0,0,0
2,0,0,0 0,0,0,0 0,0,0,0 0,0,0,0 0,0,0,0 0,0,0,0 0,0,0,0 0,0,0,0 2,0,0,0
2,0,0,0 0,0,0,0 0,0,0,0 0,0,0,0 0,0,0,0 0,0,0,0 0,0,0,0 0,0,0,0 2,0,0,0
2,0,0,0 0,0,0,0 0,0,0,0 0,0,0,0 0,0,0,0 0,0,0,0 0,0,0,0 0,0,0,0 2,0,0,0
2,0,0,0 0,0,0,0 0,0,0,0 0,0,0,0 0,0,0,0 0,0,0,0 0,0,0,0 0,0,0,0 2,0,0,0
2,0,0,0 0,0,0,0 0,0,0,0 0,0,0,0 0,0,0,0 0,0,0,0 0,0,0,0 0,0,0,0 2,0,0,0
2,0,0,0 0,0,0,0 0,0,0,0 0,0,0,0 0,0,0,0 0,0,0,0 0,0,0,0 0,0,0,0 2,0,0,0
2,0,0,0 0,0,0,0 0,0,0,0 0,0,0,0 0,0,0,0 0,0,0,0 0,0,0,0 0,0,0,0 2,0,0,0
2,0,0,0 2,0,0,0 2,0,0,0 2,0,0,0 2,0,0,0 2,0,0,0 2,0,0,0 2,0,0,0 2,0,0,0
-
3,0,0,0 3,0,0,0 3,0,0,0 3,0,0,0 3,0,0,0 3,0,0,0 3,0,0,0 3,0,0,0 3,0,0,0
3,0,0,0 3,0,0,0 0,0,0,0 0,0,0,0 0,0,0,0 0,0,0,0 0,0,0,0 3,0,0,0 3,0,0,0
3,0,0,0 0,0,0,0 0,0,0,0 0,0,0,0 0,0,0,0 0,0,0,0 0,0,0,0 0,0,0,0 3,0,0,0
3,0,0,0 0,0,0,0 0,0,0,0 0,0,0,0 3,0,0,0 0,0,0,0 0,0,0,0 0,0,0,0 3,0,0,0
3,0,0,0 0,0,0,0 0,0,0,0 0,0,0,0 3,0,0,0 0,0,0,0 0,0,0,0 0,0,0,0 3,0,0,0
3,0,0,0 0,0,0,0 0,0,0,0 3,0,0,0 3,0,0,0 3,0,0,0 3,0,0,0 0,0,0,0 3,0,0,0
3,0,0,0 0,0,0,0 0,0,0,0 3,0,0,0 0,0,0,0 0,0,0,0 0,0,0,0 0,0,0,0 3,0,0,0
3,0,0,0 0,0,0,0 0,0,0,0 0,0,0,0 0,0,0,0 0,0,0,0 3,0,0,0 0,0,0,0 3,0,0,0
3,0,0,0 0,0,0,0 0,0,0,0 0,0,0,0 0,0,0,0 0,0,0,0 0,0,0,0 3,0,0,0 3,0,0,0
3,0,0,0 0,0,0,0 0,0,0,0 0,0,0,0 0,0,0,0 0,0,0,0 3,0,0,0 0,0,0,0 3,0,0,0
3,0,0,0 0,0,0,0 0,0,0,0 0,0,0,0 0,0,0,0 0,0,0,0 0,0,0,0 3,0,0,0 3,0,0,0
3,0,0,0 0,0,0,0 0,0,0,0 0,0,0,0 0,0,0,0 0,0,0,0 3,0,0,0 3,0,0,0 3,0,0,0
3,0,0,0 0,0,0,0 0,0,0,0 0,0,0,0 0,0,0,0 0,0,0,0 0,0,0,0 0,0,0,0 3,0,0,0
3,0,0,0 0,0,0,0 0,0,0,0 0,0,0,0 0,0,0,0 0,0,0,0 0,0,0,0 0,0,0,0 3,0,0,0
3,0,0,0 0,0,0,0 0,0,0,0 0,0,0,0 0,0,0,0 0,0,0,0 0,0,0,0 0,0,0,0 3,0,0,0
3,0,0,0 0,0,0,0 0,0,0,0 0,0,0,0 0,0,0,0 0,0,0,0 0,0,0,0 0,0,0,0 3,0,0,0
3,0,0,0 0,0,0,0 0,0,0,0 0,0,0,0 0,0,0,0 0,0,0,0 0,0,0,0 0,0,0,0 3,0,0,0
3,0,0,0 0,0,0,0 3,0,0,0 3,0,0,0 0,0,0,0 0,0,0,0 0,0,0,0 0,0,0,0 3,0,0,0
3,0,0,0 0,0,0,0 3,0,0,0 3,0,0,0 0,0,0,0 0,0,0,0 0,0,0,0 0,0,0,0 3,0,0,0
3,0,0,0 0,0,0,0 0,0,0,0 3,0,0,0 0,0,0,0 0,0,0,0 0,0,0,0 0,0,0,0 3,0,0,0
3,0,0,0 0,0,0,0 0,0,0,0 0,0,0,0 0,0,0,0 0,0,0,0 0,0,0,0 0,0,0,0 3,0,0,0
3,0,0,0 0,0,0,0 0,0,0,0 0,0,0,0 0,0,0,0 0,0,0,0 0,0,0,0 0,0,0,0 3,0,0,0
3,0,0,0 0,0,0,0 0,0,0,0 0,0,0,0 0,0,0,0 0,0,0,0 0,0,0,0 0,0,0,0 3,0,0,0
3,0,0,0 0,0,0,0 0,0,0,0 0,0,0,0 0,0,0,0 0,0,0,0 0,0,0,0 0,0,0,0 3,0,0,0
3,0,0,0 0,0,0,0 0,0,0,0 0,0,0,0 0,0,0,0 0,0,0,0 0,0,0,0 0,0,0,0 3,0,0,0
3,0,0,0 0,0,0,0 0,0,0,0 0,0,0,0 0,0,0,0 0,0,0,0 0,0,0,0 0,0,0,0 3,0,0,0
3,0,0,0 0,0,0,0 0,0,0,0 0,0,0,0 0,0,0,0 0,0,0,0 0,0,0,0 0,0,0,0 3,0,0,0
3,0,0,0 0,0,0,0 0,0,0,0 0,0,0,0 0,0,0,0 0,0,0,0 0,0,0,0 0,0,0,0 3,0,0,0
3,0,0,0 0,0,0,0 0,0,0,0 0,0,0,0 0,0,0,0 0,0,0,0 0,0,0,0 0,0,0,0 3,0,0,0
3,0,0,0 0,0,0,0 0,0,0,0 3,0,0,0 0,0,0,0 3,0,0,0 0,0,0,0 0,0,0,0 3,0,0,0
3,0,0,0 0,0,0,0 0,0,0,0 3,0,0,0 0,0,0,0 3,0,0,0 0,0,0,0 0,0,0,0 3,0,0,0
3,0,0,0 0,0,0,0 0,0,0,0 3,0,0,0 0,0,0,0 3,0,0,0 0,0,0,0 0,0,0,0 3,0,0,0
3,0,0,0 0,0,0,0 0,0,0,0 3,0,0,0 0,0,0,0 3,0,0,0 0,0,0,0 0,0,0,0 3,0,0,0
3,0,0,0 0,0,0,0 0,0,0,0 0,0,0,0 0,0,0,0 0,0,0,0 0,0,0,0 0,0,0,0 3,0,0,0
3,0,0,0 0,0,0,0 0,0,0,0 0,0,0,0 0,0,0,0 0,0,0,0 0,0,0,0 0,0,0,0 3,0,0,0
3,0,0,0 0,0,0,0 0,0,0,0 0,0,0,0 0,0,0,0 0,0,0,0 0,0,0,0 0,0,0,0 3,0,0,0
3,0,0,0 0,0,0,0 3,0,0,0 0,0,0,0 0,0,0,0 0,0,0,0 0,0,0,0 0,0,0,0 3,0,0,0
3,0,0,0 0,0,0,0 0,0,0,0 0,0,0,0 0,0,0,0 0,0,0,0 0,0,0,0 0,0,0,0 3,0,0,0
3,0,0,0 0,0,0,0 0,0,0,0 0,0,0,0 7,0,0,0 0,0,0,0 0,0,0,0 0,0,0,0 3,0,0,0
3,0,0,0 0,0,0,0 0,0,0,0 0,0,0,0 7,0,0,0 0,0,0,0 0,0,0,0 0,0,0,0 3,0,0,0
3,0,0,0 0,0,0,0 0,0,0,0 0,0,0,0 7,0,0,0 0,0,0,0 0,0,0,0 0,0,0,0 3,0,0,0
3,0,0,0 0,0,0,0 0,0,0,0 0,0,0,0 0,0,0,0 0,0,0,0 0,0,0,0 0,0,0,0 3,0,0,0
3,0,0,0 0,0,0,0 0,0,0,0 0,0,0,0 0,0,0,0 0,0,0,0 0,0,0,0 0,0,0,0 3,0,0,0
3,0,0,0 0,0,0,0 0,0,0,0 0,0,0,0 0,0,0,0 0,0,0,0 0,0,0,0 0,0,0,0 3,0,0,0
3,0,0,0 3,0,0,0 3,0,0,0 3,0,0,0 3,0,0,0 3,0,0,0 3,0,0,0 3,0,0,0 3,0,0,0
-
3,0,0,0 3,0,0,0 3,0,0,0 3,0,0,0 3,0,0,0 3,0,0,0 3,0,0,0 3,0,0,0 3,0,0,0
3,0,0,0 a,0,0,0 0,0,0,0 0,0,0,0 0,0,0,0 0,0,0,0 0,0,0,0 a,0,0,0 3,0,0,0
3,0,0,0 0,0,0,0 0,0,0,0 0,0,0,0 0,0,0,0 0,0,0,0 0,0,0,0 0,0,0,0 3,0,0,0
3,0,0,0 0,0,0,0 0,0,0,0 0,0,0,0 d,0,0,0 0,0,0,0 0,0,0,0 0,0,0,0 3,0,0,0
3,0,0,0 0,0,0,0 0,0,0,0 0,0,0,0 0,0,0,0 0,0,0,0 0,0,0,0 0,0,0,0 3,0,0,0
3,0,0,0 0,0,0,0 0,0,0,0 0,0,0,0 0,0,0,0 0,0,0,0 0,0,0,0 0,0,0,0 3,0,0,0
3,0,0,0 0,0,0,0 0,0,0,0 0,0,0,0 0,0,0,0 0,0,0,0 0,0,0,0 0,0,0,0 3,0,0,0
3,0,0,0 0,0,0,0 0,0,0,0 0,0,0,0 0,0,0,0 0,0,0,0 0,0,0,0 0,0,0,0 3,0,0,0
3,0,0,0 0,0,0,0 0,0,0,0 0,0,0,0 0,0,0,0 0,0,0,0 0,0,0,0 0,0,0,0 3,0,0,0
3,0,0,0 0,0,0,0 0,0,0,0 0,0,0,0 0,0,0,0 0,0,0,0 0,0,0,0 0,0,0,0 3,0,0,0
3,0,0,0 0,0,0,0 0,0,0,0 0,0,0,0 0,0,0,0 0,0,0,0 0,0,0,0 0,0,0,0 3,0,0,0
3,0,0,0 0,0,0,0 0,0,0,0 0,0,0,0 0,0,0,0 0,0,0,0 0,0,0,0 0,0,0,0 3,0,0,0
3,0,0,0 0,0,0,0 0,0,0,0 0,0,0,0 0,0,0,0 0,0,0,0 0,0,0,0 0,0,0,0 3,0,0,0
3,0,0,0 0,0,0,0 0,0,0,0 0,0,0,0 0,0,0,0 0,0,0,0 0,0,0,0 0,0,0,0 3,0,0,0
3,0,0,0 0,0,0,0 0,0,0,0 0,0,0,0 0,0,0,0 0,0,0,0 0,0,0,0 0,0,0,0 3,0,0,0
3,0,0,0 0,0,0,0 3,0,0,0 0,0,0,0 0,0,0,0 0,0,0,0 0,0,0,0 0,0,0,0 3,0,0,0
3,0,0,0 0,0,0,0 3,0,0,0 0,0,0,0 0,0,0,0 0,0,0,0 0,0,0,0 0,0,0,0 3,0,0,0
3,0,0,0 0,0,0,0 0,0,0,0 0,0,0,0 0,0,0,0 0,0,0,0 0,0,0,0 0,0,0,0 3,0,0,0
3,0,0,0 0,0,0,0 0,0,0,0 0,0,0,0 0,0,0,0 0,0,0,0 0,0,0,0 0,0,0,0 3,0,0,0
3,0,0,0 0,0,0,0 0,0,0,0 0,0,0,0 0,0,0,0 0,0,0,0 0,0,0,0 0,0,0,0 3,0,0,0
3,0,0,0 0,0,0,0 0,0,0,0 0,0,0,0 0,0,0,0 0,0,0,0 0,0,0,0 0,0,0,0 3,0,0,0
3,0,0,0 0,0,0,0 0,0,0,0 0,0,0,0 0,0,0,0 0,0,0,0 3,0,0,0 0,0,0,0 3,0,0,0
3,0,0,0 0,0,0,0 0,0,0,0 0,0,0,0 0,0,0,0 0,0,0,0 3,0,0,0 0,0,0,0 3,0,0,0
3,0,0,0 0,0,0,0 0,0,0,0 0,0,0,0 0,0,0,0 0,0,0,0 3,0,0,0 0,0,0,0 3,0,0,0
3,0,0,0 0,0,0,0 0,0,0,0 3,0,0,0 0,0,0,0 3,0,0,0 0,0,0,0 0,0,0,0 3,0,0,0
3,0,0,0 0,0,0,0 3,0,0,0 3,0,0,0 0,0,0,0 3,0,0,0 0,0,0,0 0,0,0,0 3,0,0,0
3,0,0,0 0,0,0,0 3,0,0,0 0,0,0,0 0,0,0,0 3,0,0,0 0,0,0,0 0,0,0,0 3,0,0,0
3,0,0,0 0,0,0,0 0,0,0,0 0,0,0,0 0,0,0,0 0,0,0,0 0,0,0,0 0,0,0,0 3,0,0,0
3,0,0,0 0,0,0,0 0,0,0,0 3,0,0,0 0,0,0,0 3,0,0,0 0,0,0,0 0,0,0,0 3,0,0,0
3,0,0,0 0,0,0,0 0,0,0,0 3,0,0,0 0,0,0,0 3,0,0,0 0,0,0,0 0,0,0,0 3,0,0,0
3,0,0,0 0,0,0,0 0,0,0,0 0,0,0,0 0,0,0,0 0,0,0,0 0,0,0,0 0,0,0,0 3,0,0,0
3,0,0,0 0,0,0,0 0,0,0,0 0,0,0,0 0,0,0,0 0,0,0,0 0,0,0,0 0,0,0,0 3,0,0,0
3,0,0,0 0,0,0,0 0,0,0,0 4,0,0,0 0,0,0,0 4,0,0,0 0,0,0,0 0,0,0,0 3,0,0,0
3,0,0,0 0,0,0,0 0,0,0,0 4,0,0,0 0,0,0,0 4,0,0,0 0,0,0,0 0,0,0,0 3,0,0,0
3,0,0,0 0,0,0,0 0,0,0,0 4,0,0,0 4,0,0,0 4,0,0,0 0,0,0,0 0,0,0,0 3,0,0,0
3,0,0,0 0,0,0,0 0,0,0,0 0,0,0,0 4,0,0,0 0,0,0,0 0,0,0,0 0,0,0,0 3,0,0,0
3,0,0,0 0,0,0,0 e,0,0,0 0,0,0,0 4,0,0,0 0,0,0,0 0,0,0,0 0,0,0,0 3,0,0,0
3,0,0,0 0,0,0,0 0,0,0,0 0,0,0,0 4,0,0,0 0,0,0,0 0,0,0,0 0,0,0,0 3,0,0,0
3,0,0,0 0,0,0,0 0,0,0,0 0,0,0,0 0,0,0,0 0,0,0,0 0,0,0,0 0,0,0,0 3,0,0,0
3,0,0,0 0,0,0,0 0,0,0,0 0,0,0,0 0,0,0,0 0,0,0,0 0,0,0,0 0,0,0,0 3,0,0,0
3,0,0,0 0,0,0,0 0,0,0,0 0,0,0,0 z,0,0,0 0,0,0,0 0,0,0,0 0,0,0,0 3,0,0,0
3,0,0,0 0,0,0,0 0,0,0,0 0,0,0,0 0,0,0,0 0,0,0,0 0,0,0,0 0,0,0,0 3,0,0,0
3,0,0,0 0,0,0,0 0,0,0,0 0,0,0,0 0,0,0,0 0,0,0,0 0,0,0,0 0,0,0,0 3,0,0,0
3,0,0,0 0,0,0,0 0,0,0,0 0,0,0,0 0,0,0,0 0,0,0,0 0,0,0,0 0,0,0,0 3,0,0,0
3,0,0,0 3,0,0,0 3,0,0,0 3,0,0,0 3,0,0,0 3,0,0,0 3,0,0,0 3,0,0,0 3,0,0,0
