1 1 1 1 1 1 1 1 1
1 0 0 0 0 0 0 a 1
1 0 0 0 0 0 0 1 1
1 0 0 0 z 0 0 0 1
1 0 0 0 0 0 0 0 1
1 0 0 0 0 0 0 0 1
1 1 1 1 1 1 1 1 1
