1 0 0 0 0 1
0 0 0 0 0 0
0 0 0 a 0 0
z 0 a a 0 1
0 0 0 a 0 0
0 0 0 0 0 0
1 0 0 0 0 1
